Month,2018,2019,2020,2021,2022,Total
January,5,8,11,0,5,29
February,4,4,10,8,5,31
March,5,7,11,12,8,43
April,3,12,8,3,7,33
May,4,10,4,10,3,31
June,4,5,7,4,5,25
July,3,5,5,6,4,23
August,8,7,6,10,8,39
September,6,5,2,6,10,29
October,4,5,7,8,3,27
November,7,8,2,11,3,31
December,0,4,8,3,5,20
